##########
#........#
#.####.#.#
#.#..#.#.#
#.#.##.#.#
#...#.#..#
###.##.#.#
#....J.#.S
#.####.#.#
##########
